10.ox
......ooo.
..........
.o........
o...o.....
..........
....o..o.o
..o..o...o
..o..ooo..
oo.o...o..
..o....o..
